##########
#        #
#   E    #
#        #
#   C    #
#        #
##########
